i  adduser - add and remove users and groups
i  alacarte - easy GNOME menu editing tool
i  apt - commandline package manager
i  apt-file - search for files within Debian packages (command-line interface)
i  apt-listchanges - package change history notification tool
i  apt-transport-https - transitional package for https support
i  apt-utils - package management related utility programs
i  aptitude - terminal-based package manager
i  asciinema - Record and share your terminal sessions, the right way
i  autoconf - automatic configure script builder
i  automake - Tool for generating GNU Standards-compliant Makefiles
i  babeledit - Powerful translation editor for Angular, React and other JSON translation files
i  base-files - Debian base system miscellaneous files
i  base-passwd - Debian base system master password and group files
i  bash - GNU Bourne Again SHell
i  bash-completion - programmable completion for the bash shell
i  bind9-host - DNS lookup utility (deprecated)
i  bison - YACC-compatible parser generator
i  bsdmainutils - collection of more utilities from FreeBSD
i  bsdutils - basic utilities from 4.4BSD-Lite
i  build-essential - Informational list of build-essential packages
i  busybox - Tiny utilities for small and embedded systems
i  ccache - Compiler cache for fast recompilation of C/C++ code
i  cmake - cross-platform, open-source make system
i  cmake-qt-gui - Qt based user interface for CMake (cmake-gui)
i  code - Code editing. Redefined.
i  console-setup - console font and keymap setup program
i  context - powerful TeX format
i  coreutils - GNU core utilities
i  cpio - GNU cpio -- a program to manage archives of files
i  cppcheck - tool for static C/C++ code analysis (CLI)
i  cron - process scheduling daemon
i  curl - command line tool for transferring data with URL syntax
i  dash - POSIX-compliant shell
i  dbus - simple interprocess messaging system (daemon and utilities)
i  debconf - Debian configuration management system
i  debconf-i18n - full internationalization support for debconf
i  debian-archive-keyring - GnuPG archive keys of the Debian archive
i  debian-faq - Debian Frequently Asked Questions
i  debianutils - Miscellaneous utilities specific to Debian
i  dialog - Displays user-friendly dialog boxes from shell scripts
i  diffutils - File comparison utilities
i  dirmngr - GNU privacy guard - network certificate management service
i  discover - hardware identification system
i  dmidecode - SMBIOS/DMI table decoder
i  dmsetup - Linux Kernel Device Mapper userspace library
i  doc-debian - Debian Project documentation and other documents
i  dotnet-runtime-3.1 - Microsoft .NET Core Runtime - 3.1.2 Microsoft.NETCore.App 3.1.2
i  dotnet-sdk-3.1 - Microsoft .NET Core SDK 3.1.102
i  doxygen - Documentation system for C, C++, Java, Python and other languages
i  dpkg - Debian package management system
i  e2fsprogs - ext2/ext3/ext4 file system utilities
i  enlightenment - X11 window manager based on EFL
i  enlightenment-data - X11 window manager based on EFL - run time data files
i  fbreader - e-book reader
i  fdisk - collection of partitioning utilities
i  ffmpeg - Tools for transcoding, streaming and playing of multimedia files
i  findutils - utilities for finding files--find, xargs
i  flex - fast lexical analyzer generator
i  fontconfig - generic font configuration library - support binaries
i  fonts-powerline - prompt and statusline utility (symbols font)
i  fslint - Utility collection to find and fix common errors in file storage
i  g++-arm-linux-gnueabihf - GNU C++ compiler for the armhf architecture
i  gcc-8-base - GCC, the GNU Compiler Collection (base package)
i  gdb-multiarch - GNU Debugger (with support for multiple architectures)
i  gdbm-l10n - GNU dbm database routines (translation files) 
i  gddrescue - GNU data recovery tool
i  gettext-base - GNU Internationalization utilities for the base system
i  git - fast, scalable, distributed revision control system
i  gitg - git repository viewer
i  gnome-terminal - GNOME terminal emulator application
i  gnome-tweak-tool - adjust advanced settings for GNOME - transitional package
i  gnome-tweaks - tool to adjust advanced configuration settings for GNOME
i  gperf - Perfect hash function generator
i  gpgv - GNU privacy guard - signature verification tool
i  grep - GNU grep, egrep and fgrep
i  groff-base - GNU troff text-formatting system (base system components)
i  grub-common - GRand Unified Bootloader (common files)
i  grub-efi-amd64 - GRand Unified Bootloader, version 2 (EFI-AMD64 version)
i  gzip - GNU compression utilities
i  hdparm - tune hard disk parameters for high performance
i  hostname - utility to set/show the host name or domain name
i  htop - interactive processes viewer
i  ifupdown - high level tools to configure network interfaces
i  imagemagick - image manipulation programs -- binaries
i  init - metapackage ensuring an init system is installed
i  init-system-helpers - helper tools for all init systems
i  initramfs-tools - generic modular initramfs generator (automation)
i  inoticoming - trigger actions when files hit an incoming directory
i  installation-report - system installation report
i  iotop - simple top-like I/O monitor
i  iperf - Internet Protocol bandwidth measuring tool
i  iproute2 - networking and traffic control tools
i  iptables - administration tools for packet filtering and NAT
i  iputils-ping - Tools to test the reachability of network hosts
i  isc-dhcp-client - DHCP client for automatically obtaining an IP address
i  isc-dhcp-common - common manpages relevant to all of the isc-dhcp packages
i  kazam - screencast and screenshot application created with design in mind
i  keepass2 - Password manager
i  keyboard-configuration - system-wide keyboard preferences
i  kile - KDE Integrated LaTeX Environment
i  kmod - tools for managing Linux kernel modules
i  krb5-locales - internationalization support for MIT Kerberos
i  laptop-detect - system chassis type checker
i  less - pager program similar to more
i  lib3ds-dev - Autodesk 3D Studio file reader development files
i  libacl1 - access control list - shared library
i  libapparmor1 - changehat AppArmor library
i  libapt-inst2.0 - deb package format runtime library
i  libapt-pkg5.0 - package management runtime library
i  libargon2-1 - memory-hard hashing function - runtime library
i  libatlas-base-dev - Automatically Tuned Linear Algebra Software, generic static
i  libattr1 - extended attribute handling - shared library
i  libaudio-dev - Network Audio System - development files
i  libaudiofile-dev - Open-source version of SGI's audiofile library (header files)
i  libaudit-common - Dynamic library for security auditing - common files
i  libaudit1 - Dynamic library for security auditing
i  libavahi-compat-libdnssd-dev - Development headers for the Avahi Apple Bonjour compatibility library
i  libavcodec-dev - FFmpeg library with de/encoders for audio/video codecs - development files
i  libavformat-dev - FFmpeg library with (de)muxers for multimedia containers - development files
i  libavresample-dev - FFmpeg compatibility library for resampling - development files
i  libavutil-dev - FFmpeg library with functions for simplifying programming - development files
i  libbison-dev - YACC-compatible parser generator - development library
i  libblkid1 - block device ID library
i  libbsd0 - utility functions from BSD systems - shared library
i  libbz2-1.0 - high-quality block-sorting file compressor library - runtime
i  libc-bin - GNU C Library: Binaries
i  libc6 - GNU C Library: Shared libraries
i  libcap-ng0 - An alternate POSIX capabilities library
i  libcap2 - POSIX 1003.1e capabilities (library)
i  libcap2-bin - POSIX 1003.1e capabilities (utilities)
i  libclang1 - C, C++ and Objective-C compiler (LLVM based)
i  libcom-err2 - common error description library
i  libcryptsetup12 - disk encryption support - shared library
i  libcurl4 - easy-to-use client-side URL transfer library (OpenSSL flavour)
i  libdb5.3 - Berkeley v5.3 Database Libraries [runtime]
i  libdbus-1-dev - simple interprocess messaging system (development headers)
i  libdebconfclient0 - Debian Configuration Management System (C-implementation library)
i  libdevmapper1.02.1 - Linux Kernel Device Mapper userspace library
i  libdns-export1104 - Exported DNS Shared Library
i  libeasyloggingpp-dev - single-header logging library for C++ applications
i  libeigen3-dev - lightweight C++ template library for linear algebra
i  libelf1 - library to read and write ELF files
i  libestr0 - Helper functions for handling strings (lib)
i  libext2fs2 - ext2/ext3/ext4 file system libraries
i  libfastjson4 - fast json library for C
i  libfcitx5config-dev - Fcitx Input Method Framework v5 (config library dev files)
i  libfcitx5core-dev - Fcitx Input Method Framework v5 (core library dev files)
i  libfcitx5utils-dev - Fcitx Input Method Framework v5 (utils library dev files)
i  libfdisk1 - fdisk partitioning library
i  libffi6 - Foreign Function Interface library runtime
i  libflac-dev - Free Lossless Audio Codec - C development library
i  libfluidsynth-dev - Real-time MIDI software synthesizer (development files)
i  libfreetype6-dev - FreeType 2 font engine, development files
i  libgcc1 - GCC support library
i  libgcrypt20 - LGPL Crypto library - runtime library
i  libgl1-mesa-dev - free implementation of the OpenGL API -- GLX development files
i  libgles1 - Vendor neutral GL dispatch library -- GLESv1 support
i  libgles2 - Vendor neutral GL dispatch library -- GLESv2 support
i  libglew-dev - OpenGL Extension Wrangler - development environment
i  libglfw3-dev - portable library for OpenGL, window and input (development files)
i  libglw1-mesa-dev - GL widget library for Athena and Motif -- development files
i  libgmp10 - Multiprecision arithmetic library
i  libgnutls30 - GNU TLS library - main runtime library
i  libgpg-error0 - GnuPG development runtime library
i  libgstreamer1.0-dev - GStreamer core development files
i  libgtk-3-0 - GTK+ graphical user interface library
i  libgtk-3-dev - development files for the GTK+ library
i  libhogweed4 - low level cryptographic library (public-key cryptos)
i  libibus-1.0-dev - Intelligent Input Bus - development file
i  libidn11 - GNU Libidn library, implementation of IETF IDN specifications
i  libidn2-0 - Internationalized domain names (IDNA2008/TR46) library
i  libip4tc0 - netfilter libip4tc library
i  libip6tc0 - netfilter libip6tc library
i  libiptc0 - netfilter libiptc library
i  libisc-export1100 - Exported ISC Shared Library
i  libjack-dev - JACK Audio Connection Kit (development files)
i  libjpeg-dev - Development files for the JPEG library [dummy package]
i  libjson-c3 - JSON manipulation library - shared library
i  libkmod2 - libkmod shared library
i  liblapack-dev - Library of linear algebra routines 3 - static version
i  liblcms2-dev - Little CMS 2 color management library development headers
i  liblocale-gettext-perl - module using libc functions for internationalization in Perl
i  liblockfile-bin - support binaries for and cli utilities based on liblockfile
i  liblognorm5 - log normalizing library
i  liblua5.3-dev - Development files for the Lua language version 5.3
i  liblz4-1 - Fast LZ compression algorithm library - runtime
i  liblzma5 - XZ-format compression library
i  libmnl0 - minimalistic Netlink communication library
i  libmodplug-dev - development files for mod music based on ModPlug
i  libmount1 - device mounting library
i  libmpg123-dev - MPEG layer 1/2/3 audio decoder (development files)
i  libncurses-dev - developer's libraries for ncurses
i  libncurses5 - shared libraries for terminal handling (legacy version)
i  libncurses5-dev - transitional package for libncurses-dev
i  libncurses6 - shared libraries for terminal handling
i  libncursesw6 - shared libraries for terminal handling (wide character support)
i  libnetfilter-conntrack3 - Netfilter netlink-conntrack library
i  libnettle6 - low level cryptographic library (symmetric and one-way cryptos)
i  libnewt0.52 - Not Erik's Windowing Toolkit - text mode windowing with slang
i  libnfnetlink0 - Netfilter netlink library
i  libnftnl11 - Netfilter nftables userspace API library
i  libnss-systemd - nss module providing dynamic user and group name resolution
i  libopenal-dev - Software implementation of the OpenAL audio API (development files)
i  libopenblas-dev - Optimized BLAS (linear algebra) library (development files)
i  libopengl0 - Vendor neutral GL dispatch library -- OpenGL support
i  libopus-dev - Opus codec library development files
i  libopusfile-dev - High-level API for basic manipulation of Ogg Opus audio streams
i  libp11-kit0 - library for loading and coordinating access to PKCS#11 modules - runtime
i  libpam-modules - Pluggable Authentication Modules for PAM
i  libpam-modules-bin - Pluggable Authentication Modules for PAM - helper binaries
i  libpam-runtime - Runtime support for the PAM library
i  libpam-systemd - system and service manager - PAM module
i  libpam0g - Pluggable Authentication Modules library
i  libpcre3 - Old Perl 5 Compatible Regular Expression Library - runtime files
i  libpng++-dev - C++ interface to the PNG (Portable Network Graphics) library
i  libpng-dev - PNG library - development (version 1.6)
i  libpng16-16 - PNG library - runtime (version 1.6)
i  libpopt0 - lib for parsing cmdline parameters
i  libprocps7 - library for accessing process information from /proc
i  libprotobuf-dev - protocol buffers C++ library (development files) and proto files
i  libproxy-dev - automatic proxy configuration management library (devel)
i  libpulse-dev - PulseAudio client development headers and libraries
i  libpython3-all-dev - package depending on all supported Python 3 development packages
i  libre2-dev - efficient, principled regular expression library, development kit
i  libsamplerate0-dev - Development files for audio sample rate conversion
i  libseccomp2 - high level interface to Linux seccomp filter
i  libselinux1 - SELinux runtime shared libraries
i  libsemanage-common - Common files for SELinux policy management libraries
i  libsemanage1 - SELinux policy management library
i  libsepol1 - SELinux library for manipulating binary security policies
i  libslang2 - S-Lang programming library - runtime version
i  libsmartcols1 - smart column output alignment library
i  libsndfile1-dev - Development files for libsndfile; a library for reading/writing audio files
i  libsndio-dev - Small audio and MIDI framework from OpenBSD, development files
i  libsocksd0-dev - Development files for compiling programs with SOCKS support
i  libss2 - command-line interface parsing library
i  libssl-dev - Secure Sockets Layer toolkit - development files
i  libssl1.1 - Secure Sockets Layer toolkit - shared libraries
i  libstdc++6 - GNU Standard C++ Library v3
i  libswscale-dev - FFmpeg library for image scaling and various conversions - development files
i  libsystemd0 - systemd utility library
i  libtasn1-6 - Manage ASN.1 structures (runtime)
i  libtext-charwidth-perl - get display widths of characters on the terminal
i  libtext-iconv-perl - converts between character sets in Perl
i  libtext-wrapi18n-perl - internationalized substitute of Text::Wrap
i  libtiff-dev - Tag Image File Format library (TIFF), development files
i  libtinfo6 - shared low-level terminfo library for terminal handling
i  libudev-dev - libudev development files
i  libudev1 - libudev shared library
i  libunistring2 - Unicode string library for C
i  libuuid1 - Universally Unique ID library
i  libvpx-dev - VP8 and VP9 video codec (development files)
i  libvtk6-dev - VTK header files
i  libvulkan-dev - Vulkan loader library -- development files
i  libvulkan1 - Vulkan loader library
i  libwayland-dev - wayland compositor infrastructure - development files
i  libwebp-dev - Lossy compression of digital photographic images.
i  libx11-dev - X11 client-side library (development headers)
i  libxext-dev - X11 miscellaneous extensions library (development headers)
i  libxslt1-dev - XSLT 1.0 processing library - development kit
i  libxtables12 - netfilter xtables library
i  libxtst-dev - X11 Record extension library (development headers)
i  libzstd1 - fast lossless compression algorithm
i  linux-headers-4.19.0-6-all - All header files for Linux 4.19 (meta-package)
i  linux-headers-amd64 - Header files for Linux amd64 configuration (meta-package)
i  linux-image-amd64 - Linux for 64-bit PCs (meta-package)
i  locales - GNU C Library: National Language (locale) data [support]
i  locate - maintain and query an index of a directory tree
i  login - system login tools
i  logrotate - Log rotation utility
i  love - 2D game development framework based on Lua and OpenGL
i  lsb-base - Linux Standard Base init script functionality
i  lshw - information about hardware configuration
i  lsof - utility to list open files
i  lua5.3 - Simple, extensible, embeddable programming language
i  man-db - on-line manual pager
i  manpages - Manual pages about using a GNU/Linux system
i  mawk - a pattern scanning and text processing language
i  mercurial - easy-to-use, scalable distributed version control system
i  mesa-vulkan-drivers - Mesa Vulkan graphics drivers
i  midori - fast, lightweight graphical web browser
i  minizip - compression library - minizip tools
i  monodevelop - Development Environment for GNOME
i  mount - tools for mounting and manipulating filesystems
i  nano - small, friendly text editor inspired by Pico
i  ncurses-base - basic terminal type definitions
i  ncurses-bin - terminal-related programs and man pages
i  ncurses-term - additional terminal type definitions
i  neofetch - Shows Linux System Information with Distribution Logo
i  neovim - heavily refactored vim fork
i  net-tools - NET-3 networking toolkit
i  netbase - Basic TCP/IP networking system
i  netcat-traditional - TCP/IP swiss army knife
i  nethogs - Net top tool grouping bandwidth per process
i  nmap - The Network Mapper
i  nuget - Package manager for NuGet repos - executable
i  nvidia-legacy-340xx-driver - NVIDIA metapackage (340xx legacy version)
i  ocs-url - OCS-URL
i  openssh-client - secure shell (SSH) client, for secure access to remote machines
i  passwd - change and administer password and group data
i  pciutils - Linux PCI Utilities
i  pdftk - transitional package for pdftk, a tool for manipulating PDF documents
i  perl - Larry Wall's Practical Extraction and Report Language
i  perl-base - minimal Perl system
i  perl-modules-5.28 - Core Perl modules
i  popularity-contest - Vote for your favourite packages automatically
i  powerline - prompt and statusline utility
i  procps - /proc file system utilities
i  python - interactive high-level object-oriented language (Python2 version)
i  python-minimal - minimal subset of the Python2 language
i  python2.7 - Interactive high-level object-oriented language (version 2.7)
i  python3-reportbug - Python modules for interacting with bug tracking systems
i  readline-common - GNU readline and history libraries, common files
i  reportbug - reports bugs in the Debian distribution
i  rsync - fast, versatile, remote (and local) file-copying tool
i  rsyslog - reliable system and kernel logging daemon
i  sassc - C/C++ port of the Sass CSS precompiler - command-line tool
i  sbt - sbt, the interactive build tool
i  scons - replacement for make
i  sed - GNU stream editor for filtering/transforming text
i  sensible-utils - Utilities for sensible alternative selection
i  shellcheck - lint tool for shell scripts
i  shim-signed - Secure Boot chain-loading bootloader (Microsoft-signed binary)
i  systemd - system and service manager
i  systemd-sysv - system and service manager - SysV links
i  sysvinit-utils - System-V-like utilities
i  tar - GNU version of the tar archiving utility
i  task-british-desktop - British English desktop
i  task-cinnamon-desktop - Cinnamon
i  task-desktop - Debian desktop environment
i  task-english - General English environment
i  task-ssh-server - SSH server
i  tasksel - tool for selecting tasks for installation on Debian systems
i  tasksel-data - official tasks used for installation of Debian systems
i  telnet - basic telnet client
i  terminator - multiple GNOME terminals in one window
i  texlive-base - TeX Live: Essential programs and files
i  texlive-bibtex-extra - TeX Live: BibTeX additional styles
i  texlive-binaries - Binaries for TeX Live
i  texlive-extra-utils - TeX Live: TeX auxiliary programs
i  texlive-font-utils - TeX Live: Graphics and font utilities
i  texlive-fonts-extra - TeX Live: Additional fonts
i  texlive-fonts-extra-doc - TeX Live: Documentation files for texlive-fonts-extra
i  texlive-fonts-extra-links - TeX Live:
i  texlive-fonts-recommended - TeX Live: Recommended fonts
i  texlive-fonts-recommended-doc - TeX Live: Documentation files for texlive-fonts-recommended
i  texlive-formats-extra - TeX Live: Additional formats
i  texlive-full - TeX Live: metapackage pulling in all components of TeX Live
i  texlive-games - TeX Live: Games typesetting
i  texlive-generic-extra - TeX Live: transitional dummy package
i  texlive-generic-recommended - TeX Live: transitional dummy package
i  texlive-htmlxml - TeX Live: transitional dummy package
i  texlive-humanities - TeX Live: Humanities packages
i  texlive-humanities-doc - TeX Live: Documentation files for texlive-humanities
i  texlive-lang-african - TeX Live: transitional dummy package
i  texlive-lang-all - TeX Live: metapackage depending on all TeX Live language packages
i  texlive-lang-arabic - TeX Live: Arabic
i  texlive-lang-chinese - TeX Live: Chinese
i  texlive-lang-cjk - TeX Live: Chinese/Japanese/Korean (base)
i  texlive-lang-cyrillic - TeX Live: Cyrillic
i  texlive-lang-czechslovak - TeX Live: Czech/Slovak
i  texlive-lang-english - TeX Live: US and UK English
i  texlive-lang-european - TeX Live: Other European languages
i  texlive-lang-french - TeX Live: French
i  texlive-lang-german - TeX Live: German
i  texlive-lang-greek - TeX Live: Greek
i  texlive-lang-indic - TeX Live: transitional dummy package
i  texlive-lang-italian - TeX Live: Italian
i  texlive-lang-japanese - TeX Live: Japanese
i  texlive-lang-korean - TeX Live: Korean
i  texlive-lang-other - TeX Live: Other languages
i  texlive-lang-polish - TeX Live: Polish
i  texlive-lang-portuguese - TeX Live: Portuguese
i  texlive-lang-spanish - TeX Live: Spanish
i  texlive-latex-base - TeX Live: LaTeX fundamental packages
i  texlive-latex-base-doc - TeX Live: Documentation files for texlive-latex-base
i  texlive-latex-extra - TeX Live: LaTeX additional packages
i  texlive-latex-extra-doc - TeX Live: Documentation files for texlive-latex-extra
i  texlive-latex-recommended - TeX Live: LaTeX recommended packages
i  texlive-latex-recommended-doc - TeX Live: Documentation files for texlive-latex-recommended
i  texlive-luatex - TeX Live: LuaTeX packages
i  texlive-metapost - TeX Live: MetaPost and Metafont packages
i  texlive-metapost-doc - TeX Live: Documentation files for texlive-metapost
i  texlive-music - TeX Live: Music packages
i  texlive-omega - TeX Live: transitional dummy package
i  texlive-pictures - TeX Live: Graphics, pictures, diagrams
i  texlive-pictures-doc - TeX Live: Documentation files for texlive-pictures
i  texlive-plain-extra - TeX Live: transitional dummy package
i  texlive-plain-generic - TeX Live: Plain (La)TeX packages
i  texlive-pstricks - TeX Live: PSTricks
i  texlive-pstricks-doc - TeX Live: Documentation files for texlive-pstricks
i  texlive-publishers - TeX Live: Publisher styles, theses, etc.
i  texlive-publishers-doc - TeX Live: Documentation files for texlive-publishers
i  texlive-science - TeX Live: Mathematics, natural sciences, computer science packages
i  texlive-science-doc - TeX Live: Documentation files for texlive-science
i  texlive-xetex - TeX Live: XeTeX and packages
i  tightvncserver - virtual network computing server software
i  tmux - terminal multiplexer
i  traceroute - Traces the route taken by packets over an IPv4/IPv6 network
i  tzdata - time zone and daylight-saving time data
i  ucf - Update Configuration File(s): preserve user changes to config files
i  udev - /dev/ and hotplug management daemon
i  usbutils - Linux USB utilities
i  util-linux - miscellaneous system utilities
i  vim - Vi IMproved - enhanced vi editor
i  vim-common - Vi IMproved - Common files
i  vim-tiny - Vi IMproved - enhanced vi editor - compact version
i  vtk7 - Binaries for VTK7
i  vulkan-utils - transitional package
i  wamerican - American English dictionary words for /usr/share/dict
i  wget - retrieves files from the web
i  whiptail - Displays user-friendly dialog boxes from shell scripts
i  wireshark - network traffic analyzer - meta-package
i  xfce4 - Meta-package for the Xfce Lightweight Desktop Environment
i  xfce4-goodies - enhancements for the Xfce4 Desktop Environment
i  xfonts-100dpi - 100 dpi fonts for X
i  xfonts-100dpi-transcoded - 100 dpi fonts for X (transcoded from ISO 10646-1)
i  xfonts-75dpi - 75 dpi fonts for X
i  xfonts-75dpi-transcoded - 75 dpi fonts for X (transcoded from ISO 10646-1)
i  xfonts-a12k12 - 12-dot Kanji & ASCII fonts for X
i  xfonts-ayu - Gothic 18/20 dot Japanese and ISO-8859-1 X11 bitmap fonts
i  xfonts-baekmuk - Baekmuk bitmap Korean fonts for X
i  xfonts-base - standard fonts for X
i  xfonts-biznet-100dpi - 100 dpi BIZNET ISO-8859-2 fonts for X servers
i  xfonts-biznet-75dpi - 75 dpi BIZNET ISO-8859-2 fonts for X servers
i  xfonts-biznet-base - Standard BIZNET ISO-8859-2 fonts for X servers
i  xfonts-bolkhov-75dpi - 75 dpi Unicode Cyrillic fonts for X (Cyr-RFX collection)
i  xfonts-bolkhov-cp1251-75dpi - 75 dpi CP1251 encoded Cyrillic fonts for X (Cyr-RFX collection)
i  xfonts-bolkhov-cp1251-misc - Character-cell CP1251 encoded Cyrillic fonts for X (Cyr-RFX collection)
i  xfonts-bolkhov-isocyr-75dpi - 75 dpi ISO 8859-5 encoded Cyrillic fonts for X (Cyr-RFX collection)
i  xfonts-bolkhov-isocyr-misc - Character-cell ISO-8859-5 encoded Cyrillic fonts for X (Cyr-RFX collection)
i  xfonts-bolkhov-koi8r-75dpi - 75 dpi KOI8-R encoded Cyrillic fonts for X (Cyr-RFX collection)
i  xfonts-bolkhov-koi8r-misc - Character-cell KOI8-R encoded Cyrillic fonts for X (Cyr-RFX collection)
i  xfonts-bolkhov-koi8u-75dpi - 75 dpi KOI8-U encoded Cyrillic fonts for X (Cyr-RFX collection)
i  xfonts-bolkhov-koi8u-misc - Character-cell KOI8-U encoded Cyrillic fonts for X (Cyr-RFX collection)
i  xfonts-bolkhov-misc - Character-cell Unicode Cyrillic fonts for X (Cyr-RFX collection)
i  xfonts-cronyx-100dpi - 100 dpi Unicode Cyrillic fonts for X (Cronyx collection)
i  xfonts-cronyx-75dpi - 75 dpi Unicode Cyrillic fonts for X (Cronyx collection)
i  xfonts-cronyx-cp1251-100dpi - 100 dpi CP1251 encoded Cyrillic fonts for X (Cronyx collection)
i  xfonts-cronyx-cp1251-75dpi - 75 dpi CP1251 encoded Cyrillic fonts for X (Cronyx collection)
i  xfonts-cronyx-cp1251-misc - Character-cell CP1251 encoded Cyrillic fonts for X (Cronyx collection)
i  xfonts-cronyx-isocyr-100dpi - 100 dpi ISO 8859-5 encoded Cyrillic fonts for X (Cronyx collection)
i  xfonts-cronyx-isocyr-75dpi - 75 dpi ISO 8859-5 encoded Cyrillic fonts for X (Cronyx collection)
i  xfonts-cronyx-isocyr-misc - Character-cell ISO-8859-5 encoded Cyrillic fonts for X (Cronyx collection)
i  xfonts-cronyx-koi8r-100dpi - 100 dpi KOI8-R encoded Cyrillic fonts for X (Cronyx collection)
i  xfonts-cronyx-koi8r-75dpi - 75 dpi KOI8-R encoded Cyrillic fonts for X (Cronyx collection)
i  xfonts-cronyx-koi8r-misc - Character-cell KOI8-R encoded Cyrillic fonts for X (Cronyx collection)
i  xfonts-cronyx-koi8u-100dpi - 100 dpi KOI8-U encoded Cyrillic fonts for X (Cronyx collection)
i  xfonts-cronyx-koi8u-75dpi - 75 dpi KOI8-U encoded Cyrillic fonts for X (Cronyx collection)
i  xfonts-cronyx-koi8u-misc - Character-cell KOI8-U encoded Cyrillic fonts for X (Cronyx collection)
i  xfonts-cronyx-misc - Character-cell Unicode Cyrillic fonts for X (Cronyx collection)
i  xfonts-cyrillic - Cyrillic fonts for X
i  xfonts-efont-unicode - /efont/ Unicode fonts for X which cover various scripts
i  xfonts-efont-unicode-ib - /efont/ Unicode fonts for X (italic and bold)
i  xfonts-encodings - Encodings for X.Org fonts
i  xfonts-intl-arabic - international fonts for X - Arabic
i  xfonts-intl-asian - international fonts for X - (south-east) Asian
i  xfonts-intl-chinese - international fonts for X - Chinese
i  xfonts-intl-chinese-big - international fonts for X - large Chinese
i  xfonts-intl-european - international fonts for X - European
i  xfonts-intl-japanese - international fonts for X - Japanese
i  xfonts-intl-japanese-big - international fonts for X - large Japanese
i  xfonts-intl-phonetic - international fonts for X - International Phonetic Alphabet
i  xfonts-jisx0213 - JIS X 0213 Japanese Kanji bitmap fonts for X
i  xfonts-jmk - Jim Knoble's character-cell fonts for X
i  xfonts-kaname - Kaname Cho 12 dot Japanese Kanji, Latin 1 fonts for X11
i  xfonts-kapl - APL fonts for A+ development
i  xfonts-kappa20 - X11 Kappa 20dot Fonts (ISO-8859-1..4/9/10/13..16, Japanese) with bold
i  xfonts-libdockapp - Window Maker Dock App support (fonts)
i  xfonts-marumoji - Roundish fonts (marumoji fonts) for X
i  xfonts-mona - Proportional X fonts for 2ch ASCII art
i  xfonts-mplus - M+ bitmap 10/12 dot Latin/Japanese fonts for X11
i  xfonts-nexus - Nexus font for X
i  xfonts-scalable - scalable fonts for X
i  xfonts-shinonome - Various 12,14,16 dot Japanese Kanji, iso8859-1 fonts for X11
i  xfonts-terminus - Fixed-width fonts for fast reading
i  xfonts-terminus-dos - Fixed-width fonts for DOS encodings
i  xfonts-terminus-oblique - Oblique version of the Terminus font
i  xfonts-thai - Collection of Thai fonts for X (metapackage)
i  xfonts-thai-etl - Thai etl fonts for X
i  xfonts-thai-manop - Manop Wongsaisuwan's bitmap fonts for X
i  xfonts-thai-nectec - Thai fixed fonts for X from Nectec
i  xfonts-thai-poonlap - Poonlap Veerathanabutr's bitmap fonts for X
i  xfonts-thai-vor - Voradesh Yenbut's bitmap fonts for X
i  xfonts-tipa - X11 PostScript Type 1 font for the Phonetic Alphabet
i  xfonts-traditional - Traditional fixed-width fonts for X
i  xfonts-unifont - PCF (bitmap) version of GNU Unifont
i  xfonts-utils - X Window System font utility programs
i  xfonts-wqy - WenQuanYi Bitmap Song CJK font for X
i  xfonts-x3270-misc - Font files for the x3270(1) IBM 3270 emulator
i  xsltproc - XSLT 1.0 command line processor
i  xterm - X terminal emulator
i  xxd - tool to make (or reverse) a hex dump
i  yarn - Fast, reliable, and secure dependency management.
i  zlib1g - compression library - runtime
i  zsh - shell with lots of features
